# lvlwidth 21
# lvlheight 23
# bgcolor 0 0 0
# edgelightcolor 203 211 44
# edgeshadowcolor 0 64 0
# fillcolor 0 0 0
# pelletcolor 255 0 0

# startleveldata
113 21 107 100 100 100 100 100 100 100 133 100 100 100 100 100 100 100 108 21 113 
101 0 110 0 0 2 2 2 2 2 110 2 2 2 2 2 0 0 110 0 101 
101 0 0 0 113 2 113 2 113 2 2 2 113 2 113 2 113 0 0 0 101 
131 100 100 100 106 3 110 2 110 2 113 2 110 2 110 3 105 100 100 100 132 
101 2 2 2 2 2 2 2 2 2 101 2 2 2 2 2 2 2 2 2 101 
101 2 107 100 112 2 113 0 111 100 140 100 112 0 113 2 111 100 108 2 101 
101 2 101 2 2 2 101 0 0 0 101 0 0 0 101 2 2 2 101 2 101 
101 2 110 2 111 100 130 100 112 0 110 0 111 100 130 100 112 2 110 2 101 
101 2 2 2 0 0 0 0 0 0 10 0 0 0 0 0 0 2 2 2 101 
101 2 111 100 100 100 108 0 107 112 1 111 108 0 107 100 100 100 112 2 101 
101 2 2 2 2 2 110 0 101 11 12 13 101 0 110 2 2 2 2 2 101 
105 100 100 100 112 2 2 2 131 100 100 100 132 2 2 2 111 100 100 100 106 
20 0 0 0 0 0 113 2 110 0 0 0 110 2 113 0 0 0 0 0 20 
107 100 100 100 100 100 106 2 0 0 113 0 0 2 105 100 100 100 100 100 108 
101 2 2 2 2 2 2 2 111 100 140 100 112 2 2 2 2 2 2 2 101 
101 2 113 2 107 100 108 0 0 0 101 0 0 0 107 100 108 2 113 2 101 
101 2 101 2 110 0 105 100 112 0 110 0 111 100 106 0 110 2 101 2 101 
101 2 101 2 2 2 2 2 2 2 4 2 2 2 2 2 2 2 101 2 101 
101 2 110 2 120 2 111 100 108 2 113 2 107 100 112 2 120 2 110 2 101 
101 2 2 2 3 2 2 2 101 2 101 2 101 2 2 2 3 2 2 2 101 
101 0 113 2 111 100 112 2 110 2 110 2 110 2 111 100 112 2 113 0 101 
101 0 101 2 2 2 2 2 2 2 2 2 2 2 2 2 2 2 101 0 101 
110 21 105 100 100 100 100 100 100 100 100 100 100 100 100 100 100 100 106 21 110 
# endleveldata

# sprites
