# lvlwidth 21
# lvlheight 23
# bgcolor 0 0 0
# edgecolor 255 128 128
# fillcolor 100 100 100
# pelletcolor 170 0 85

# startleveldata
120 21 111 100 108 0 107 100 100 100 100 100 100 100 108 0 107 100 112 21 120 
20 2 2 2 105 100 106 2 2 2 2 2 2 2 105 100 106 2 2 2 20 
113 3 120 2 2 2 2 2 111 100 133 100 112 2 2 2 2 2 120 3 113 
101 2 2 2 107 100 108 2 2 2 101 2 2 2 107 100 108 2 2 2 101 
105 100 100 100 106 0 101 2 113 2 101 2 113 2 101 0 105 100 100 100 106 
0 0 0 0 0 0 101 2 101 2 101 2 101 2 101 0 0 0 0 0 0 
107 100 100 100 100 100 106 2 101 2 110 2 101 2 105 100 100 100 100 100 108 
101 2 2 2 2 2 2 2 101 2 2 2 101 2 2 2 2 2 2 2 101 
101 2 113 2 113 2 111 100 130 112 0 111 130 100 112 2 113 2 113 2 101 
101 2 101 2 101 2 2 2 2 2 4 2 2 2 2 2 101 2 101 2 101 
101 2 110 2 105 100 100 112 2 113 0 113 2 111 100 100 106 2 110 2 101 
101 2 2 2 2 2 2 2 2 101 0 101 2 2 2 2 2 2 2 2 101 
105 100 108 2 107 112 2 107 100 106 0 105 100 108 2 111 108 2 107 100 106 
0 0 101 2 101 2 2 101 2 2 2 2 2 101 2 2 101 2 101 0 0 
0 0 101 2 110 2 111 106 2 111 100 112 2 105 112 2 110 2 101 0 0 
0 0 101 2 2 2 2 2 2 0 10 0 2 2 2 2 2 2 101 0 0 
0 0 105 100 108 2 120 2 107 112 1 111 108 2 120 2 107 100 106 0 0 
0 0 0 0 101 2 2 2 101 11 12 13 101 2 2 2 101 0 0 0 0 
0 0 0 0 101 2 120 2 105 100 100 100 106 2 120 2 101 0 0 0 0 
0 0 0 0 101 2 2 2 2 2 2 2 2 2 2 2 101 0 0 0 0 
111 100 100 100 106 0 113 2 111 100 100 100 112 2 113 0 105 100 100 100 112 
20 0 0 0 0 0 101 2 2 2 3 2 2 2 101 0 0 0 0 0 20 
120 21 111 100 100 100 130 100 100 100 100 100 100 100 130 100 100 100 112 21 120 
# endleveldata

# sprites
